Alison	Brown	Pledge
Boxi	Chen	Pledge
Julia	D'Zmura	Pledge
Laura	Exar	Pledge
Kelci 	Fitzpatrick	Pledge
Alex	Frier	Pledge
Hodalis	Gaytan	Pledge
Sophia 	Godin	Pledge
Delaney	Greene	Pledge
Briley	Hebner	Pledge
Sumaiya (Mya)	Johnson	Pledge
Grace	Johnson	Pledge
Zachary	Kirby	Pledge
Christina	Kratzmeier	Pledge
Sarina	Lamb	Pledge
Maanasa	Maadhavan	Pledge
Maggie	McGuckin	Pledge
Joey	Mitchell	Pledge
Jaleh	Montazer	Pledge
Hayley	Myren	Pledge
Liz	Nguyen	Pledge
Drew	Norfolk	Pledge
Mir	Pandya	Pledge
Alexandra	Pichler	Pledge
Josh	Pike	Pledge
Gabby	Reyes	Pledge
Samantha	Ridenour	Pledge
Morgan	Robinson	Pledge
Abril	Schujman	Pledge
Yuzhu	Shi	Pledge
Chris	Smith	Pledge
Joyce	Song	Pledge
Meghan	Stromberg	Pledge
Saveena	Suri	Pledge
Sydni	Thomas	Pledge
Katharine	Tilmes	Pledge
Chris	Valdes	Pledge
Sydney	White	Pledge
Quinten	Williams	Pledge
Abramowitz	Marli	Brother
Addo	Doreen	Brother
Altmann	Mijal	Brother
Ansell	Ryan	Brother
Anvari	Morgan	Brother
Atzl	William	Brother
Bagalkotkar	Sandhya	Brother
Bernstein	Ilana	Brother
Blevins	Kaila	Brother
Bodziak	Carmen	Brother
Bourne	Blake	Brother
Breads	Faith	Brother
Briskin	Hanna	Brother
Brooks	Ashley	Brother
Cain	Devin	Brother
Chanakira	Elijah 	Brother
Chastain	Tanner	Brother
Chen	Tianxin	Brother
Cohn	Ben	Brother
Datri	Steph	Brother
Dillon	Rachel 	Brother
Dinkin	Jordan	Brother
Dogra	Reema	Brother
Dudley	Sarah	Brother
Dwyer	Patrick	Brother
Edwards	Julia	Brother
Elliot	Kristina	Brother
Fein	Michael	Brother
Flynn	Natalie	Brother
Fritzsche	Brenna	Brother
Fuchs	Lauren	Brother
Garriques	Victoria	Brother
Gaviria	Toni	Brother
Gaynor	Ali	Brother
Goldstein	Alexander	Brother
Good	Meredith	Brother
Heng	Mary	Brother
Hirschfeld	Kyra	Brother
Hofmeister	Eric	Brother
Horen	Lindsay	Brother
Howard	Emma	Brother
Iandiorio	Amy	Brother
Ismail	Tahira	Brother
Jariwala	Sanjeev	Brother
Kalotra	Priyanka	Brother
Kelley	Jillian	Brother
Kelly	Grace	Brother
Kiriyanthan	Marilyn	Brother
Kotgire	Prath	Brother
Lee	Hannah	Brother
Leinbach	Sarah	Brother
Leinbach	Natalie	Brother
Lema	Nate	Brother
Luo	Vicky	Brother
Lupinski	Lauren	Brother
Luthers	Chris	Brother
Ma	Daphne	Brother
Madera	Nelson	Brother
Malik	Seher	Brother
McComas	Caroline	Brother
McGill	Arthur	Brother
McGinnis	Elise	Brother
Mitchell	Chris	Brother
Molina	Josette	Brother
Mookerjee	Shourjya	Brother
Morrill	Ben	Brother
Munger	Paul	Brother
Naviasky	Sara	Brother
Norton	Rachel	Brother
Pederson	Lilli	Brother
Phelps	Quinn	Brother
Piazza	Jessica	Brother
Piel	Austin	Brother
Pignataro	Shannon	Brother
Pirtle	Ryan	Brother
Rees	Maddie 	Brother
Rei	Isa	Brother
Robertson	Mac	Brother
Rosen	Lindsay	Brother
Ruskowski	Sally	Brother
Santos	Hugo	Brother
Sauber	Maggie	Brother
Scherr	Ben	Brother
Sen	Shaanit	Brother
Shallom	Sharon	Brother
Siewierski	Jennifer	Brother
Smith	Megan	Brother
Stein	Mia	Brother
Sullivan	Katie	Brother
Sullivan	Michael	Brother
Suryavanshi	Ashwin	Brother
Tabler	Nicholas	Brother
Tracey	Annie	Brother
Valdez	Alex	Brother
Walkow	Jeri	Brother
Wilkins	Samantha	Brother
Williams	Megan	Brother
Wink	Peter	Brother
Witting	Claire	Brother